5 8
# ### ##
##  ####
  ######
#######
## ## ##